1111111
1000001
100C001
1E00001
1000001
1000P01
1111111
