11111111111111111111111111111111111
10000000000000000000000000000000001
11111111100000011111000000001111111
10000000000000000CCC000000000000001
100000C00000000000000000000000000E1
11111111111111100000P00000111111111
10000000000000000000000000000001001
11111111111111111111111111111111111
