11111111111111111111111111111111111111111
1E0000000000000000000000000000P0000100001
1100000000000000000000000C000000001000001
11100000000000000000000000000000010000001
11110000000000000000000000000000100000001
11111000000000000000000000000001000000001
11111111111111111111111111111111111111111
