111111111111111111111111
10000P0000000000000001
100000000000000000001
10000C0000000000001
10000000000000001
1000000C0000001
10000C0000001
100C0000001
1C0000001
1000C1
1E001
11111
