111111111E1111
P0000000000001
C0000000000001
11111111111111
