1111111111111111111
1000000000000000001
100000P000000000001
1000000000C00000001
1000 000000000000E1
1111111111111111111
