1111111111111111111
1000000000000000001
1000C00001000000001
100000001P1000000E1
1111111111111111111
