111111111111111111111111111111
10000000000000P0000000000000E1
111110000000000000000000000111
100000000011110000011100000001
1000000000CCC000000CCC00000001
100011100000000011100000001111
100000000000000000000000000001
110000000000000000000000000011
111000000000000000000000000111
111100000000000000000000001111
111110000000000000000000011111
111111000000000000000000111111
111111100000000001000001111111
111111111000100000000011111111
111111111100000000000111111111
111111111000001110000011111111
111111111000000C00000011111111
111111111111111111111111111111
