111111111111111111111111111111111111111
1C0000000000000000000000P00000000000001
10000000C000000000000000000000000000001
100000000000000000000000000000000000001
10000000000000000C000000000001000000111
1C000000000000000C0000000000010000000E1
111111111111111111101111111111111111111
100000000000000001C01000000000000000001
100000000000000010001000000000000000001
111111111111111111111111111111111111111
