111111
10C011
10P001
10EB01
111111
